,team_traded_x,team_trade_with_x,Count_x,team_traded_y,team_trade_with_y,Count_y,total
0,ANA,ARI,20,ARI,ANA,13,33
1,ANA,BOS,44,BOS,ANA,304,348
2,ANA,BUF,22,BUF,ANA,142,164
3,ANA,CAR,25,CAR,ANA,20,45
4,ANA,CBJ,19,CBJ,ANA,56,75
5,ANA,CGY,11,CGY,ANA,44,55
6,ANA,CHI,14,CHI,ANA,26,40
7,ANA,COL,28,COL,ANA,52,80
8,ANA,DAL,12,DAL,ANA,15,27
9,ANA,DET,7,DET,ANA,41,48
10,ANA,EDM,17,EDM,ANA,192,209
11,ANA,FLA,6,FLA,ANA,10,16
12,ANA,LAK,13,LAK,ANA,40,53
13,ANA,MIN,20,MIN,ANA,39,59
14,ANA,MTL,26,MTL,ANA,176,202
15,ANA,NJD,17,NJD,ANA,52,69
16,ANA,NSH,5,NSH,ANA,14,19
17,ANA,NYI,20,NYI,ANA,38,58
18,ANA,NYR,10,NYR,ANA,81,91
19,ANA,OTT,25,OTT,ANA,96,121
20,ANA,PHI,7,PHI,ANA,64,71
21,ANA,PIT,51,PIT,ANA,384,435
22,ANA,SEA,13,SEA,ANA,9,22
23,ANA,SJS,4,SJS,ANA,18,22
24,ANA,STL,14,STL,ANA,48,62
25,ANA,TBL,12,TBL,ANA,35,47
26,ANA,TOR,38,TOR,ANA,491,529
27,ANA,VAN,47,VAN,ANA,309,356
28,ANA,VGK,15,VGK,ANA,9,24
29,ANA,WPG,10,WPG,ANA,66,76
30,ANA,WSH,14,WSH,ANA,35,49
31,ARI,ANA,13,ANA,ARI,20,33
32,ARI,BOS,26,BOS,ARI,174,200
33,ARI,BUF,11,BUF,ARI,172,183
34,ARI,CAR,12,CAR,ARI,97,109
35,ARI,CBJ,18,CBJ,ARI,57,75
36,ARI,CGY,16,CGY,ARI,92,108
37,ARI,CHI,23,CHI,ARI,59,82
38,ARI,COL,22,COL,ARI,86,108
39,ARI,DAL,9,DAL,ARI,18,27
40,ARI,DET,20,DET,ARI,105,125
41,ARI,EDM,26,EDM,ARI,182,208
42,ARI,FLA,10,FLA,ARI,16,26
43,ARI,LAK,20,LAK,ARI,39,59
44,ARI,MIN,15,MIN,ARI,65,80
45,ARI,MTL,26,MTL,ARI,257,283
46,ARI,NJD,16,NJD,ARI,77,93
47,ARI,NSH,9,NSH,ARI,36,45
48,ARI,NYI,20,NYI,ARI,87,107
49,ARI,NYR,21,NYR,ARI,78,99
50,ARI,OTT,13,OTT,ARI,178,191
51,ARI,PHI,18,PHI,ARI,75,93
52,ARI,PIT,30,PIT,ARI,406,436
53,ARI,SEA,10,SEA,ARI,21,31
54,ARI,SJS,11,SJS,ARI,37,48
55,ARI,STL,18,STL,ARI,65,83
56,ARI,TBL,9,TBL,ARI,96,105
57,ARI,TOR,51,TOR,ARI,919,970
58,ARI,VAN,50,VAN,ARI,235,285
59,ARI,VGK,13,VGK,ARI,13,26
60,ARI,WPG,18,WPG,ARI,111,129
61,ARI,WSH,27,WSH,ARI,133,160
62,BOS,ANA,304,ANA,BOS,44,348
63,BOS,ARI,174,ARI,BOS,26,200
64,BOS,BUF,62,BUF,BOS,48,110
65,BOS,CAR,74,CAR,BOS,43,117
66,BOS,CBJ,145,CBJ,BOS,51,196
67,BOS,CGY,118,CGY,BOS,29,147
68,BOS,CHI,147,CHI,BOS,67,214
69,BOS,COL,86,COL,BOS,22,108
70,BOS,DAL,44,DAL,BOS,5,49
71,BOS,DET,51,DET,BOS,33,84
72,BOS,EDM,101,EDM,BOS,75,176
73,BOS,FLA,25,FLA,BOS,4,29
74,BOS,LAK,231,LAK,BOS,16,247
75,BOS,MIN,41,MIN,BOS,7,48
76,BOS,MTL,25,MTL,BOS,29,54
77,BOS,NJD,74,NJD,BOS,62,136
78,BOS,NSH,59,NSH,BOS,8,67
79,BOS,NYI,29,NYI,BOS,18,47
80,BOS,NYR,13,NYR,BOS,15,28
81,BOS,OTT,73,OTT,BOS,57,130
82,BOS,PHI,41,PHI,BOS,33,74
83,BOS,PIT,218,PIT,BOS,183,401
84,BOS,SEA,139,SEA,BOS,12,151
85,BOS,SJS,48,SJS,BOS,23,71
86,BOS,STL,45,STL,BOS,20,65
87,BOS,TBL,4,TBL,BOS,2,6
88,BOS,TOR,14,TOR,BOS,66,80
89,BOS,VAN,44,VAN,BOS,92,136
90,BOS,VGK,21,VGK,BOS,6,27
91,BOS,WPG,63,WPG,BOS,75,138
92,BOS,WSH,61,WSH,BOS,32,93
93,BUF,ANA,142,ANA,BUF,22,164
94,BUF,ARI,172,ARI,BUF,11,183
95,BUF,BOS,48,BOS,BUF,62,110
96,BUF,CAR,137,CAR,BUF,40,177
97,BUF,CBJ,60,CBJ,BUF,14,74
98,BUF,CGY,130,CGY,BUF,102,232
99,BUF,CHI,93,CHI,BUF,77,170
100,BUF,COL,43,COL,BUF,26,69
101,BUF,DAL,59,DAL,BUF,10,69
102,BUF,DET,17,DET,BUF,8,25
103,BUF,EDM,38,EDM,BUF,67,105
104,BUF,FLA,28,FLA,BUF,11,39
105,BUF,LAK,74,LAK,BUF,31,105
106,BUF,MIN,85,MIN,BUF,64,149
107,BUF,MTL,34,MTL,BUF,69,103
108,BUF,NJD,20,NJD,BUF,34,54
109,BUF,NSH,127,NSH,BUF,29,156
110,BUF,NYI,64,NYI,BUF,19,83
111,BUF,NYR,35,NYR,BUF,55,90
112,BUF,OTT,29,OTT,BUF,29,58
113,BUF,PHI,113,PHI,BUF,66,179
114,BUF,PIT,85,PIT,BUF,142,227
115,BUF,SEA,105,SEA,BUF,11,116
116,BUF,SJS,74,SJS,BUF,29,103
117,BUF,STL,48,STL,BUF,23,71
118,BUF,TBL,53,TBL,BUF,20,73
119,BUF,TOR,49,TOR,BUF,235,284
120,BUF,VAN,83,VAN,BUF,74,157
121,BUF,VGK,61,VGK,BUF,8,69
122,BUF,WPG,304,WPG,BUF,194,498
123,BUF,WSH,62,WSH,BUF,17,79
124,CAR,ANA,20,ANA,CAR,25,45
125,CAR,ARI,97,ARI,CAR,12,109
126,CAR,BOS,43,BOS,CAR,74,117
127,CAR,BUF,40,BUF,CAR,137,177
128,CAR,CBJ,20,CBJ,CAR,20,40
129,CAR,CGY,64,CGY,CAR,102,166
130,CAR,CHI,18,CHI,CAR,18,36
131,CAR,COL,7,COL,CAR,28,35
132,CAR,DAL,6,DAL,CAR,8,14
133,CAR,DET,16,DET,CAR,24,40
134,CAR,EDM,21,EDM,CAR,129,150
135,CAR,FLA,10,FLA,CAR,9,19
136,CAR,LAK,28,LAK,CAR,18,46
137,CAR,MIN,12,MIN,CAR,16,28
138,CAR,MTL,13,MTL,CAR,44,57
139,CAR,NJD,8,NJD,CAR,15,23
140,CAR,NSH,26,NSH,CAR,20,46
141,CAR,NYI,18,NYI,CAR,24,42
142,CAR,NYR,20,NYR,CAR,29,49
143,CAR,OTT,70,OTT,CAR,112,182
144,CAR,PHI,81,PHI,CAR,96,177
145,CAR,PIT,16,PIT,CAR,54,70
146,CAR,SEA,11,SEA,CAR,13,24
147,CAR,SJS,24,SJS,CAR,15,39
148,CAR,STL,11,STL,CAR,18,29
149,CAR,TBL,12,TBL,CAR,11,23
150,CAR,TOR,110,TOR,CAR,345,455
151,CAR,VAN,43,VAN,CAR,108,151
152,CAR,VGK,13,VGK,CAR,7,20
153,CAR,WPG,147,WPG,CAR,177,324
154,CAR,WSH,20,WSH,CAR,30,50
155,CBJ,ANA,56,ANA,CBJ,19,75
156,CBJ,ARI,57,ARI,CBJ,18,75
157,CBJ,BOS,51,BOS,CBJ,145,196
158,CBJ,BUF,14,BUF,CBJ,60,74
159,CBJ,CAR,20,CAR,CBJ,20,40
160,CBJ,CGY,133,CGY,CBJ,164,297
161,CBJ,CHI,49,CHI,CBJ,34,83
162,CBJ,COL,36,COL,CBJ,66,102
163,CBJ,DAL,16,DAL,CBJ,4,20
164,CBJ,DET,13,DET,CBJ,48,61
165,CBJ,EDM,22,EDM,CBJ,153,175
166,CBJ,FLA,22,FLA,CBJ,15,37
167,CBJ,LAK,29,LAK,CBJ,14,43
168,CBJ,MIN,12,MIN,CBJ,25,37
169,CBJ,MTL,36,MTL,CBJ,87,123
170,CBJ,NJD,24,NJD,CBJ,37,61
171,CBJ,NSH,27,NSH,CBJ,13,40
172,CBJ,NYI,6,NYI,CBJ,21,27
173,CBJ,NYR,13,NYR,CBJ,18,31
174,CBJ,OTT,13,OTT,CBJ,41,54
175,CBJ,PHI,107,PHI,CBJ,255,362
176,CBJ,PIT,24,PIT,CBJ,143,167
177,CBJ,SEA,16,SEA,CBJ,10,26
178,CBJ,SJS,22,SJS,CBJ,20,42
179,CBJ,STL,25,STL,CBJ,32,57
180,CBJ,TBL,12,TBL,CBJ,20,32
181,CBJ,TOR,57,TOR,CBJ,299,356
182,CBJ,VAN,65,VAN,CBJ,178,243
183,CBJ,VGK,20,VGK,CBJ,3,23
184,CBJ,WPG,52,WPG,CBJ,75,127
185,CBJ,WSH,29,WSH,CBJ,109,138
186,CGY,ANA,44,ANA,CGY,11,55
187,CGY,ARI,92,ARI,CGY,16,108
188,CGY,BOS,29,BOS,CGY,118,147
189,CGY,BUF,102,BUF,CGY,130,232
190,CGY,CAR,102,CAR,CGY,64,166
191,CGY,CBJ,164,CBJ,CGY,133,297
192,CGY,CHI,37,CHI,CGY,34,71
193,CGY,COL,74,COL,CGY,41,115
194,CGY,DAL,48,DAL,CGY,4,52
195,CGY,DET,144,DET,CGY,82,226
196,CGY,EDM,12,EDM,CGY,37,49
197,CGY,FLA,71,FLA,CGY,34,105
198,CGY,LAK,51,LAK,CGY,16,67
199,CGY,MIN,31,MIN,CGY,18,49
200,CGY,MTL,37,MTL,CGY,68,105
201,CGY,NJD,34,NJD,CGY,46,80
202,CGY,NSH,26,NSH,CGY,15,41
203,CGY,NYI,33,NYI,CGY,19,52
204,CGY,NYR,45,NYR,CGY,28,73
205,CGY,OTT,76,OTT,CGY,57,133
206,CGY,PHI,33,PHI,CGY,35,68
207,CGY,PIT,91,PIT,CGY,196,287
208,CGY,SEA,39,SEA,CGY,24,63
209,CGY,SJS,25,SJS,CGY,13,38
210,CGY,STL,38,STL,CGY,41,79
211,CGY,TBL,10,TBL,CGY,10,20
212,CGY,TOR,183,TOR,CGY,695,878
213,CGY,VAN,27,VAN,CGY,59,86
214,CGY,VGK,10,VGK,CGY,4,14
215,CGY,WPG,43,WPG,CGY,63,106
216,CGY,WSH,34,WSH,CGY,42,76
217,CHI,ANA,26,ANA,CHI,14,40
218,CHI,ARI,59,ARI,CHI,23,82
219,CHI,BOS,67,BOS,CHI,147,214
220,CHI,BUF,77,BUF,CHI,93,170
221,CHI,CAR,18,CAR,CHI,18,36
222,CHI,CBJ,34,CBJ,CHI,49,83
223,CHI,CGY,34,CGY,CHI,37,71
224,CHI,COL,44,COL,CHI,33,77
225,CHI,DAL,33,DAL,CHI,17,50
226,CHI,DET,22,DET,CHI,28,50
227,CHI,EDM,65,EDM,CHI,240,305
228,CHI,FLA,16,FLA,CHI,13,29
229,CHI,LAK,92,LAK,CHI,59,151
230,CHI,MIN,36,MIN,CHI,24,60
231,CHI,MTL,44,MTL,CHI,122,166
232,CHI,NJD,29,NJD,CHI,55,84
233,CHI,NSH,18,NSH,CHI,15,33
234,CHI,NYI,187,NYI,CHI,157,344
235,CHI,NYR,69,NYR,CHI,58,127
236,CHI,OTT,42,OTT,CHI,74,116
237,CHI,PHI,49,PHI,CHI,17,66
238,CHI,PIT,129,PIT,CHI,221,350
239,CHI,SEA,26,SEA,CHI,9,35
240,CHI,SJS,27,SJS,CHI,12,39
241,CHI,STL,22,STL,CHI,20,42
242,CHI,TBL,74,TBL,CHI,59,133
243,CHI,TOR,197,TOR,CHI,692,889
244,CHI,VAN,231,VAN,CHI,256,487
245,CHI,VGK,24,VGK,CHI,16,40
246,CHI,WPG,32,WPG,CHI,68,100
247,CHI,WSH,98,WSH,CHI,70,168
248,COL,ANA,52,ANA,COL,28,80
249,COL,ARI,86,ARI,COL,22,108
250,COL,BOS,22,BOS,COL,86,108
251,COL,BUF,26,BUF,COL,43,69
252,COL,CAR,28,CAR,COL,7,35
253,COL,CBJ,66,CBJ,COL,36,102
254,COL,CGY,41,CGY,COL,74,115
255,COL,CHI,33,CHI,COL,44,77
256,COL,DAL,1,DAL,COL,3,4
257,COL,DET,19,DET,COL,22,41
258,COL,EDM,10,EDM,COL,12,22
259,COL,FLA,35,FLA,COL,7,42
260,COL,LAK,25,LAK,COL,8,33
261,COL,MIN,4,MIN,COL,5,9
262,COL,MTL,38,MTL,COL,56,94
263,COL,NJD,32,NJD,COL,23,55
264,COL,NSH,30,NSH,COL,15,45
265,COL,NYI,14,NYI,COL,40,54
266,COL,NYR,26,NYR,COL,32,58
267,COL,OTT,30,OTT,COL,22,52
268,COL,PHI,66,PHI,COL,96,162
269,COL,PIT,50,PIT,COL,94,144
270,COL,SEA,10,SEA,COL,7,17
271,COL,SJS,23,SJS,COL,21,44
272,COL,STL,7,STL,COL,3,10
273,COL,TBL,4,TBL,COL,7,11
274,COL,TOR,42,TOR,COL,194,236
275,COL,VAN,26,VAN,COL,35,61
276,COL,VGK,10,VGK,COL,4,14
277,COL,WPG,89,WPG,COL,95,184
278,COL,WSH,74,WSH,COL,79,153
279,DAL,ANA,15,ANA,DAL,12,27
280,DAL,ARI,18,ARI,DAL,9,27
281,DAL,BOS,5,BOS,DAL,44,49
282,DAL,BUF,10,BUF,DAL,59,69
283,DAL,CAR,8,CAR,DAL,6,14
284,DAL,CBJ,4,CBJ,DAL,16,20
285,DAL,CGY,4,CGY,DAL,48,52
286,DAL,CHI,17,CHI,DAL,33,50
287,DAL,COL,3,COL,DAL,1,4
288,DAL,DET,9,DET,DAL,21,30
289,DAL,EDM,7,EDM,DAL,29,36
290,DAL,FLA,6,FLA,DAL,6,12
291,DAL,LAK,12,LAK,DAL,8,20
292,DAL,MIN,5,MIN,DAL,7,12
293,DAL,MTL,13,MTL,DAL,76,89
294,DAL,NJD,3,NJD,DAL,5,8
295,DAL,NSH,9,NSH,DAL,12,21
296,DAL,NYI,8,NYI,DAL,2,10
297,DAL,NYR,1,NYR,DAL,8,9
298,DAL,OTT,12,OTT,DAL,22,34
299,DAL,PHI,6,PHI,DAL,48,54
300,DAL,PIT,7,PIT,DAL,79,86
301,DAL,SEA,13,SEA,DAL,1,14
302,DAL,SJS,6,SJS,DAL,19,25
303,DAL,STL,3,STL,DAL,4,7
304,DAL,TBL,1,TBL,DAL,3,4
305,DAL,TOR,19,TOR,DAL,154,173
306,DAL,VAN,11,VAN,DAL,68,79
307,DAL,VGK,2,VGK,DAL,2,4
308,DAL,WPG,8,WPG,DAL,26,34
309,DAL,WSH,4,WSH,DAL,10,14
310,DET,ANA,41,ANA,DET,7,48
311,DET,ARI,105,ARI,DET,20,125
312,DET,BOS,33,BOS,DET,51,84
313,DET,BUF,8,BUF,DET,17,25
314,DET,CAR,24,CAR,DET,16,40
315,DET,CBJ,48,CBJ,DET,13,61
316,DET,CGY,82,CGY,DET,144,226
317,DET,CHI,28,CHI,DET,22,50
318,DET,COL,22,COL,DET,19,41
319,DET,DAL,21,DAL,DET,9,30
320,DET,EDM,36,EDM,DET,96,132
321,DET,FLA,11,FLA,DET,3,14
322,DET,LAK,80,LAK,DET,29,109
323,DET,MIN,54,MIN,DET,63,117
324,DET,MTL,25,MTL,DET,67,92
325,DET,NJD,20,NJD,DET,28,48
326,DET,NSH,73,NSH,DET,31,104
327,DET,NYI,25,NYI,DET,28,53
328,DET,NYR,35,NYR,DET,64,99
329,DET,OTT,202,OTT,DET,187,389
330,DET,PHI,79,PHI,DET,120,199
331,DET,PIT,83,PIT,DET,249,332
332,DET,SEA,12,SEA,DET,5,17
333,DET,SJS,48,SJS,DET,26,74
334,DET,STL,28,STL,DET,21,49
335,DET,TBL,23,TBL,DET,23,46
336,DET,TOR,111,TOR,DET,196,307
337,DET,VAN,99,VAN,DET,112,211
338,DET,VGK,20,VGK,DET,11,31
339,DET,WPG,128,WPG,DET,185,313
340,DET,WSH,31,WSH,DET,12,43
341,EDM,ANA,192,ANA,EDM,17,209
342,EDM,ARI,182,ARI,EDM,26,208
343,EDM,BOS,75,BOS,EDM,101,176
344,EDM,BUF,67,BUF,EDM,38,105
345,EDM,CAR,129,CAR,EDM,21,150
346,EDM,CBJ,153,CBJ,EDM,22,175
347,EDM,CGY,37,CGY,EDM,12,49
348,EDM,CHI,240,CHI,EDM,65,305
349,EDM,COL,12,COL,EDM,10,22
350,EDM,DAL,29,DAL,EDM,7,36
351,EDM,DET,96,DET,EDM,36,132
352,EDM,FLA,26,FLA,EDM,7,33
353,EDM,LAK,21,LAK,EDM,5,26
354,EDM,MIN,34,MIN,EDM,10,44
355,EDM,MTL,55,MTL,EDM,93,148
356,EDM,NJD,44,NJD,EDM,24,68
357,EDM,NSH,84,NSH,EDM,13,97
358,EDM,NYI,45,NYI,EDM,12,57
359,EDM,NYR,19,NYR,EDM,14,33
360,EDM,OTT,53,OTT,EDM,19,72
361,EDM,PHI,209,PHI,EDM,92,301
362,EDM,PIT,78,PIT,EDM,107,185
363,EDM,SEA,83,SEA,EDM,5,88
364,EDM,SJS,121,SJS,EDM,51,172
365,EDM,STL,60,STL,EDM,29,89
366,EDM,TBL,12,TBL,EDM,6,18
367,EDM,TOR,42,TOR,EDM,176,218
368,EDM,VAN,48,VAN,EDM,22,70
369,EDM,VGK,9,VGK,EDM,3,12
370,EDM,WPG,127,WPG,EDM,66,193
371,EDM,WSH,79,WSH,EDM,18,97
372,FLA,ANA,10,ANA,FLA,6,16
373,FLA,ARI,16,ARI,FLA,10,26
374,FLA,BOS,4,BOS,FLA,25,29
375,FLA,BUF,11,BUF,FLA,28,39
376,FLA,CAR,9,CAR,FLA,10,19
377,FLA,CBJ,15,CBJ,FLA,22,37
378,FLA,CGY,34,CGY,FLA,71,105
379,FLA,CHI,13,CHI,FLA,16,29
380,FLA,COL,7,COL,FLA,35,42
381,FLA,DAL,6,DAL,FLA,6,12
382,FLA,DET,3,DET,FLA,11,14
383,FLA,EDM,7,EDM,FLA,26,33
384,FLA,LAK,9,LAK,FLA,5,14
385,FLA,MIN,7,MIN,FLA,17,24
386,FLA,MTL,18,MTL,FLA,63,81
387,FLA,NJD,8,NJD,FLA,22,30
388,FLA,NSH,5,NSH,FLA,11,16
389,FLA,NYI,1,NYI,FLA,6,7
390,FLA,NYR,4,NYR,FLA,33,37
391,FLA,OTT,15,OTT,FLA,28,43
392,FLA,PHI,7,PHI,FLA,26,33
393,FLA,PIT,6,PIT,FLA,91,97
394,FLA,SEA,9,SEA,FLA,4,13
395,FLA,SJS,15,SJS,FLA,17,32
396,FLA,STL,6,STL,FLA,28,34
397,FLA,TOR,12,TOR,FLA,50,62
398,FLA,VAN,12,VAN,FLA,88,100
399,FLA,VGK,9,VGK,FLA,4,13
400,FLA,WPG,12,WPG,FLA,73,85
401,FLA,WSH,8,WSH,FLA,11,19
402,LAK,ANA,40,ANA,LAK,13,53
403,LAK,ARI,39,ARI,LAK,20,59
404,LAK,BOS,16,BOS,LAK,231,247
405,LAK,BUF,31,BUF,LAK,74,105
406,LAK,CAR,18,CAR,LAK,28,46
407,LAK,CBJ,14,CBJ,LAK,29,43
408,LAK,CGY,16,CGY,LAK,51,67
409,LAK,CHI,59,CHI,LAK,92,151
410,LAK,COL,8,COL,LAK,25,33
411,LAK,DAL,8,DAL,LAK,12,20
412,LAK,DET,29,DET,LAK,80,109
413,LAK,EDM,5,EDM,LAK,21,26
414,LAK,FLA,5,FLA,LAK,9,14
415,LAK,MIN,10,MIN,LAK,13,23
416,LAK,MTL,39,MTL,LAK,131,170
417,LAK,NJD,9,NJD,LAK,39,48
418,LAK,NSH,25,NSH,LAK,18,43
419,LAK,NYI,5,NYI,LAK,47,52
420,LAK,NYR,2,NYR,LAK,33,35
421,LAK,OTT,19,OTT,LAK,45,64
422,LAK,PHI,37,PHI,LAK,108,145
423,LAK,PIT,20,PIT,LAK,105,125
424,LAK,SEA,15,SEA,LAK,8,23
425,LAK,SJS,7,SJS,LAK,15,22
426,LAK,STL,11,STL,LAK,12,23
427,LAK,TBL,1,TBL,LAK,8,9
428,LAK,TOR,40,TOR,LAK,401,441
429,LAK,VAN,6,VAN,LAK,47,53
430,LAK,VGK,2,VGK,LAK,5,7
431,LAK,WPG,83,WPG,LAK,183,266
432,LAK,WSH,13,WSH,LAK,24,37
433,MIN,ANA,39,ANA,MIN,20,59
434,MIN,ARI,65,ARI,MIN,15,80
435,MIN,BOS,7,BOS,MIN,41,48
436,MIN,BUF,64,BUF,MIN,85,149
437,MIN,CAR,16,CAR,MIN,12,28
438,MIN,CBJ,25,CBJ,MIN,12,37
439,MIN,CGY,18,CGY,MIN,31,49
440,MIN,CHI,24,CHI,MIN,36,60
441,MIN,COL,5,COL,MIN,4,9
442,MIN,DAL,7,DAL,MIN,5,12
443,MIN,DET,63,DET,MIN,54,117
444,MIN,EDM,10,EDM,MIN,34,44
445,MIN,FLA,17,FLA,MIN,7,24
446,MIN,LAK,13,LAK,MIN,10,23
447,MIN,MTL,32,MTL,MIN,50,82
448,MIN,NJD,15,NJD,MIN,34,49
449,MIN,NSH,12,NSH,MIN,12,24
450,MIN,NYI,14,NYI,MIN,14,28
451,MIN,NYR,16,NYR,MIN,36,52
452,MIN,OTT,25,OTT,MIN,15,40
453,MIN,PHI,21,PHI,MIN,47,68
454,MIN,PIT,80,PIT,MIN,167,247
455,MIN,SEA,18,SEA,MIN,3,21
456,MIN,SJS,16,SJS,MIN,7,23
457,MIN,STL,17,STL,MIN,6,23
458,MIN,TBL,5,TBL,MIN,16,21
459,MIN,TOR,23,TOR,MIN,182,205
460,MIN,VAN,20,VAN,MIN,45,65
461,MIN,VGK,3,VGK,MIN,5,8
462,MIN,WPG,22,WPG,MIN,60,82
463,MIN,WSH,21,WSH,MIN,26,47
464,MTL,ANA,176,ANA,MTL,26,202
465,MTL,ARI,257,ARI,MTL,26,283
466,MTL,BOS,29,BOS,MTL,25,54
467,MTL,BUF,69,BUF,MTL,34,103
468,MTL,CAR,44,CAR,MTL,13,57
469,MTL,CBJ,87,CBJ,MTL,36,123
470,MTL,CGY,68,CGY,MTL,37,105
471,MTL,CHI,122,CHI,MTL,44,166
472,MTL,COL,56,COL,MTL,38,94
473,MTL,DAL,76,DAL,MTL,13,89
474,MTL,DET,67,DET,MTL,25,92
475,MTL,EDM,93,EDM,MTL,55,148
476,MTL,FLA,63,FLA,MTL,18,81
477,MTL,LAK,131,LAK,MTL,39,170
478,MTL,MIN,50,MIN,MTL,32,82
479,MTL,NJD,47,NJD,MTL,27,74
480,MTL,NSH,40,NSH,MTL,17,57
481,MTL,NYI,51,NYI,MTL,14,65
482,MTL,NYR,137,NYR,MTL,64,201
483,MTL,OTT,59,OTT,MTL,27,86
484,MTL,PHI,156,PHI,MTL,63,219
485,MTL,PIT,199,PIT,MTL,140,339
486,MTL,SEA,65,SEA,MTL,5,70
487,MTL,SJS,62,SJS,MTL,17,79
488,MTL,STL,47,STL,MTL,13,60
489,MTL,TBL,47,TBL,MTL,12,59
490,MTL,TOR,74,TOR,MTL,120,194
491,MTL,VAN,103,VAN,MTL,96,199
492,MTL,VGK,38,VGK,MTL,4,42
493,MTL,WPG,618,WPG,MTL,326,944
494,MTL,WSH,186,WSH,MTL,74,260
495,NJD,ANA,52,ANA,NJD,17,69
496,NJD,ARI,77,ARI,NJD,16,93
497,NJD,BOS,62,BOS,NJD,74,136
498,NJD,BUF,34,BUF,NJD,20,54
499,NJD,CAR,15,CAR,NJD,8,23
500,NJD,CBJ,37,CBJ,NJD,24,61
501,NJD,CGY,46,CGY,NJD,34,80
502,NJD,CHI,55,CHI,NJD,29,84
503,NJD,COL,23,COL,NJD,32,55
504,NJD,DAL,5,DAL,NJD,3,8
505,NJD,DET,28,DET,NJD,20,48
506,NJD,EDM,24,EDM,NJD,44,68
507,NJD,FLA,22,FLA,NJD,8,30
508,NJD,LAK,39,LAK,NJD,9,48
509,NJD,MIN,34,MIN,NJD,15,49
510,NJD,MTL,27,MTL,NJD,47,74
511,NJD,NSH,63,NSH,NJD,13,76
512,NJD,NYI,18,NYI,NJD,15,33
513,NJD,NYR,6,NYR,NJD,6,12
514,NJD,OTT,74,OTT,NJD,41,115
515,NJD,PHI,24,PHI,NJD,13,37
516,NJD,PIT,38,PIT,NJD,74,112
517,NJD,SEA,28,SEA,NJD,2,30
518,NJD,SJS,42,SJS,NJD,16,58
519,NJD,STL,28,STL,NJD,6,34
520,NJD,TBL,87,TBL,NJD,25,112
521,NJD,TOR,71,TOR,NJD,135,206
522,NJD,VAN,58,VAN,NJD,73,131
523,NJD,VGK,23,VGK,NJD,3,26
524,NJD,WPG,104,WPG,NJD,111,215
525,NJD,WSH,46,WSH,NJD,28,74
526,NSH,ANA,14,ANA,NSH,5,19
527,NSH,ARI,36,ARI,NSH,9,45
528,NSH,BOS,8,BOS,NSH,59,67
529,NSH,BUF,29,BUF,NSH,127,156
530,NSH,CAR,20,CAR,NSH,26,46
531,NSH,CBJ,13,CBJ,NSH,27,40
532,NSH,CGY,15,CGY,NSH,26,41
533,NSH,CHI,15,CHI,NSH,18,33
534,NSH,COL,15,COL,NSH,30,45
535,NSH,DAL,12,DAL,NSH,9,21
536,NSH,DET,31,DET,NSH,73,104
537,NSH,EDM,13,EDM,NSH,84,97
538,NSH,FLA,11,FLA,NSH,5,16
539,NSH,LAK,18,LAK,NSH,25,43
540,NSH,MIN,12,MIN,NSH,12,24
541,NSH,MTL,17,MTL,NSH,40,57
542,NSH,NJD,13,NJD,NSH,63,76
543,NSH,NYI,22,NYI,NSH,53,75
544,NSH,NYR,12,NYR,NSH,28,40
545,NSH,OTT,36,OTT,NSH,104,140
546,NSH,PHI,12,PHI,NSH,31,43
547,NSH,PIT,16,PIT,NSH,131,147
548,NSH,SEA,17,SEA,NSH,6,23
549,NSH,SJS,16,SJS,NSH,15,31
550,NSH,STL,4,STL,NSH,6,10
551,NSH,TBL,5,TBL,NSH,15,20
552,NSH,TOR,32,TOR,NSH,229,261
553,NSH,VAN,39,VAN,NSH,166,205
554,NSH,VGK,5,VGK,NSH,2,7
555,NSH,WPG,20,WPG,NSH,28,48
556,NSH,WSH,11,WSH,NSH,14,25
557,NYI,ANA,38,ANA,NYI,20,58
558,NYI,ARI,87,ARI,NYI,20,107
559,NYI,BOS,18,BOS,NYI,29,47
560,NYI,BUF,19,BUF,NYI,64,83
561,NYI,CAR,24,CAR,NYI,18,42
562,NYI,CBJ,21,CBJ,NYI,6,27
563,NYI,CGY,19,CGY,NYI,33,52
564,NYI,CHI,157,CHI,NYI,187,344
565,NYI,COL,40,COL,NYI,14,54
566,NYI,DAL,2,DAL,NYI,8,10
567,NYI,DET,28,DET,NYI,25,53
568,NYI,EDM,12,EDM,NYI,45,57
569,NYI,FLA,6,FLA,NYI,1,7
570,NYI,LAK,47,LAK,NYI,5,52
571,NYI,MIN,14,MIN,NYI,14,28
572,NYI,MTL,14,MTL,NYI,51,65
573,NYI,NJD,15,NJD,NYI,18,33
574,NYI,NSH,53,NSH,NYI,22,75
575,NYI,NYR,4,NYR,NYI,13,17
576,NYI,OTT,32,OTT,NYI,19,51
577,NYI,PHI,11,PHI,NYI,30,41
578,NYI,PIT,9,PIT,NYI,33,42
579,NYI,SEA,17,SEA,NYI,12,29
580,NYI,SJS,13,SJS,NYI,38,51
581,NYI,STL,11,STL,NYI,21,32
582,NYI,TBL,3,TBL,NYI,5,8
583,NYI,TOR,44,TOR,NYI,155,199
584,NYI,VAN,32,VAN,NYI,49,81
585,NYI,VGK,6,VGK,NYI,4,10
586,NYI,WPG,43,WPG,NYI,40,83
587,NYI,WSH,2,WSH,NYI,6,8
588,NYR,ANA,81,ANA,NYR,10,91
589,NYR,ARI,78,ARI,NYR,21,99
590,NYR,BOS,15,BOS,NYR,13,28
591,NYR,BUF,55,BUF,NYR,35,90
592,NYR,CAR,29,CAR,NYR,20,49
593,NYR,CBJ,18,CBJ,NYR,13,31
594,NYR,CGY,28,CGY,NYR,45,73
595,NYR,CHI,58,CHI,NYR,69,127
596,NYR,COL,32,COL,NYR,26,58
597,NYR,DAL,8,DAL,NYR,1,9
598,NYR,DET,64,DET,NYR,35,99
599,NYR,EDM,14,EDM,NYR,19,33
600,NYR,FLA,33,FLA,NYR,4,37
601,NYR,LAK,33,LAK,NYR,2,35
602,NYR,MIN,36,MIN,NYR,16,52
603,NYR,MTL,64,MTL,NYR,137,201
604,NYR,NJD,6,NJD,NYR,6,12
605,NYR,NSH,28,NSH,NYR,12,40
606,NYR,NYI,13,NYI,NYR,4,17
607,NYR,OTT,32,OTT,NYR,43,75
608,NYR,PHI,27,PHI,NYR,25,52
609,NYR,PIT,8,PIT,NYR,19,27
610,NYR,SEA,50,SEA,NYR,3,53
611,NYR,SJS,35,SJS,NYR,19,54
612,NYR,STL,20,STL,NYR,11,31
613,NYR,TBL,14,TBL,NYR,12,26
614,NYR,TOR,74,TOR,NYR,200,274
615,NYR,VAN,49,VAN,NYR,78,127
616,NYR,VGK,24,VGK,NYR,2,26
617,NYR,WPG,44,WPG,NYR,76,120
618,NYR,WSH,31,WSH,NYR,14,45
619,OTT,ANA,96,ANA,OTT,25,121
620,OTT,ARI,178,ARI,OTT,13,191
621,OTT,BOS,57,BOS,OTT,73,130
622,OTT,BUF,29,BUF,OTT,29,58
623,OTT,CAR,112,CAR,OTT,70,182
624,OTT,CBJ,41,CBJ,OTT,13,54
625,OTT,CGY,57,CGY,OTT,76,133
626,OTT,CHI,74,CHI,OTT,42,116
627,OTT,COL,22,COL,OTT,30,52
628,OTT,DAL,22,DAL,OTT,12,34
629,OTT,DET,187,DET,OTT,202,389
630,OTT,EDM,19,EDM,OTT,53,72
631,OTT,FLA,28,FLA,OTT,15,43
632,OTT,LAK,45,LAK,OTT,19,64
633,OTT,MIN,15,MIN,OTT,25,40
634,OTT,MTL,27,MTL,OTT,59,86
635,OTT,NJD,41,NJD,OTT,74,115
636,OTT,NSH,104,NSH,OTT,36,140
637,OTT,NYI,19,NYI,OTT,32,51
638,OTT,NYR,43,NYR,OTT,32,75
639,OTT,PHI,164,PHI,OTT,83,247
640,OTT,PIT,84,PIT,OTT,177,261
641,OTT,SEA,71,SEA,OTT,19,90
642,OTT,SJS,56,SJS,OTT,21,77
643,OTT,STL,38,STL,OTT,18,56
644,OTT,TBL,46,TBL,OTT,20,66
645,OTT,TOR,42,TOR,OTT,121,163
646,OTT,VAN,45,VAN,OTT,94,139
647,OTT,VGK,41,VGK,OTT,19,60
648,OTT,WPG,76,WPG,OTT,81,157
649,OTT,WSH,67,WSH,OTT,67,134
650,PHI,ANA,64,ANA,PHI,7,71
651,PHI,ARI,75,ARI,PHI,18,93
652,PHI,BOS,33,BOS,PHI,41,74
653,PHI,BUF,66,BUF,PHI,113,179
654,PHI,CAR,96,CAR,PHI,81,177
655,PHI,CBJ,255,CBJ,PHI,107,362
656,PHI,CGY,35,CGY,PHI,33,68
657,PHI,CHI,17,CHI,PHI,49,66
658,PHI,COL,96,COL,PHI,66,162
659,PHI,DAL,48,DAL,PHI,6,54
660,PHI,DET,120,DET,PHI,79,199
661,PHI,EDM,92,EDM,PHI,209,301
662,PHI,FLA,26,FLA,PHI,7,33
663,PHI,LAK,108,LAK,PHI,37,145
664,PHI,MIN,47,MIN,PHI,21,68
665,PHI,MTL,63,MTL,PHI,156,219
666,PHI,NJD,13,NJD,PHI,24,37
667,PHI,NSH,31,NSH,PHI,12,43
668,PHI,NYI,30,NYI,PHI,11,41
669,PHI,NYR,25,NYR,PHI,27,52
670,PHI,OTT,83,OTT,PHI,164,247
671,PHI,PIT,27,PIT,PHI,84,111
672,PHI,SEA,77,SEA,PHI,13,90
673,PHI,SJS,32,SJS,PHI,9,41
674,PHI,STL,48,STL,PHI,36,84
675,PHI,TBL,39,TBL,PHI,38,77
676,PHI,TOR,158,TOR,PHI,694,852
677,PHI,VAN,66,VAN,PHI,78,144
678,PHI,VGK,27,VGK,PHI,8,35
679,PHI,WPG,42,WPG,PHI,65,107
680,PHI,WSH,33,WSH,PHI,38,71
681,PIT,ANA,384,ANA,PIT,51,435
682,PIT,ARI,406,ARI,PIT,30,436
683,PIT,BOS,183,BOS,PIT,218,401
684,PIT,BUF,142,BUF,PIT,85,227
685,PIT,CAR,54,CAR,PIT,16,70
686,PIT,CBJ,143,CBJ,PIT,24,167
687,PIT,CGY,196,CGY,PIT,91,287
688,PIT,CHI,221,CHI,PIT,129,350
689,PIT,COL,94,COL,PIT,50,144
690,PIT,DAL,79,DAL,PIT,7,86
691,PIT,DET,249,DET,PIT,83,332
692,PIT,EDM,107,EDM,PIT,78,185
693,PIT,FLA,91,FLA,PIT,6,97
694,PIT,LAK,105,LAK,PIT,20,125
695,PIT,MIN,167,MIN,PIT,80,247
696,PIT,MTL,140,MTL,PIT,199,339
697,PIT,NJD,74,NJD,PIT,38,112
698,PIT,NSH,131,NSH,PIT,16,147
699,PIT,NYI,33,NYI,PIT,9,42
700,PIT,NYR,19,NYR,PIT,8,27
701,PIT,OTT,177,OTT,PIT,84,261
702,PIT,PHI,84,PHI,PIT,27,111
703,PIT,SEA,184,SEA,PIT,18,202
704,PIT,SJS,110,SJS,PIT,40,150
705,PIT,STL,86,STL,PIT,52,138
706,PIT,TBL,56,TBL,PIT,11,67
707,PIT,TOR,183,TOR,PIT,392,575
708,PIT,VAN,278,VAN,PIT,216,494
709,PIT,VGK,53,VGK,PIT,14,67
710,PIT,WPG,237,WPG,PIT,86,323
711,PIT,WSH,39,WSH,PIT,7,46
712,SEA,ANA,9,ANA,SEA,13,22
713,SEA,ARI,21,ARI,SEA,10,31
714,SEA,BOS,12,BOS,SEA,139,151
715,SEA,BUF,11,BUF,SEA,105,116
716,SEA,CAR,13,CAR,SEA,11,24
717,SEA,CBJ,10,CBJ,SEA,16,26
718,SEA,CGY,24,CGY,SEA,39,63
719,SEA,CHI,9,CHI,SEA,26,35
720,SEA,COL,7,COL,SEA,10,17
721,SEA,DAL,1,DAL,SEA,13,14
722,SEA,DET,5,DET,SEA,12,17
723,SEA,EDM,5,EDM,SEA,83,88
724,SEA,FLA,4,FLA,SEA,9,13
725,SEA,LAK,8,LAK,SEA,15,23
726,SEA,MIN,3,MIN,SEA,18,21
727,SEA,MTL,5,MTL,SEA,65,70
728,SEA,NJD,2,NJD,SEA,28,30
729,SEA,NSH,6,NSH,SEA,17,23
730,SEA,NYI,12,NYI,SEA,17,29
731,SEA,NYR,3,NYR,SEA,50,53
732,SEA,OTT,19,OTT,SEA,71,90
733,SEA,PHI,13,PHI,SEA,77,90
734,SEA,PIT,18,PIT,SEA,184,202
735,SEA,SJS,17,SJS,SEA,35,52
736,SEA,STL,11,STL,SEA,14,25
737,SEA,TOR,15,TOR,SEA,219,234
738,SEA,VAN,8,VAN,SEA,37,45
739,SEA,VGK,6,VGK,SEA,6,12
740,SEA,WPG,19,WPG,SEA,67,86
741,SEA,WSH,4,WSH,SEA,38,42
742,SJS,ANA,18,ANA,SJS,4,22
743,SJS,ARI,37,ARI,SJS,11,48
744,SJS,BOS,23,BOS,SJS,48,71
745,SJS,BUF,29,BUF,SJS,74,103
746,SJS,CAR,15,CAR,SJS,24,39
747,SJS,CBJ,20,CBJ,SJS,22,42
748,SJS,CGY,13,CGY,SJS,25,38
749,SJS,CHI,12,CHI,SJS,27,39
750,SJS,COL,21,COL,SJS,23,44
751,SJS,DAL,19,DAL,SJS,6,25
752,SJS,DET,26,DET,SJS,48,74
753,SJS,EDM,51,EDM,SJS,121,172
754,SJS,FLA,17,FLA,SJS,15,32
755,SJS,LAK,15,LAK,SJS,7,22
756,SJS,MIN,7,MIN,SJS,16,23
757,SJS,MTL,17,MTL,SJS,62,79
758,SJS,NJD,16,NJD,SJS,42,58
759,SJS,NSH,15,NSH,SJS,16,31
760,SJS,NYI,38,NYI,SJS,13,51
761,SJS,NYR,19,NYR,SJS,35,54
762,SJS,OTT,21,OTT,SJS,56,77
763,SJS,PHI,9,PHI,SJS,32,41
764,SJS,PIT,40,PIT,SJS,110,150
765,SJS,SEA,35,SEA,SJS,17,52
766,SJS,STL,19,STL,SJS,30,49
767,SJS,TBL,11,TBL,SJS,29,40
768,SJS,TOR,86,TOR,SJS,466,552
769,SJS,VAN,24,VAN,SJS,43,67
770,SJS,VGK,6,VGK,SJS,7,13
771,SJS,WPG,15,WPG,SJS,18,33
772,SJS,WSH,33,WSH,SJS,42,75
773,STL,ANA,48,ANA,STL,14,62
774,STL,ARI,65,ARI,STL,18,83
775,STL,BOS,20,BOS,STL,45,65
776,STL,BUF,23,BUF,STL,48,71
777,STL,CAR,18,CAR,STL,11,29
778,STL,CBJ,32,CBJ,STL,25,57
779,STL,CGY,41,CGY,STL,38,79
780,STL,CHI,20,CHI,STL,22,42
781,STL,COL,3,COL,STL,7,10
782,STL,DAL,4,DAL,STL,3,7
783,STL,DET,21,DET,STL,28,49
784,STL,EDM,29,EDM,STL,60,89
785,STL,FLA,28,FLA,STL,6,34
786,STL,LAK,12,LAK,STL,11,23
787,STL,MIN,6,MIN,STL,17,23
788,STL,MTL,13,MTL,STL,47,60
789,STL,NJD,6,NJD,STL,28,34
790,STL,NSH,6,NSH,STL,4,10
791,STL,NYI,21,NYI,STL,11,32
792,STL,NYR,11,NYR,STL,20,31
793,STL,OTT,18,OTT,STL,38,56
794,STL,PHI,36,PHI,STL,48,84
795,STL,PIT,52,PIT,STL,86,138
796,STL,SEA,14,SEA,STL,11,25
797,STL,SJS,30,SJS,STL,19,49
798,STL,TBL,17,TBL,STL,18,35
799,STL,TOR,34,TOR,STL,211,245
800,STL,VAN,12,VAN,STL,29,41
801,STL,VGK,9,VGK,STL,2,11
802,STL,WPG,13,WPG,STL,26,39
803,STL,WSH,14,WSH,STL,19,33
804,TBL,ANA,35,ANA,TBL,12,47
805,TBL,ARI,96,ARI,TBL,9,105
806,TBL,BOS,2,BOS,TBL,4,6
807,TBL,BUF,20,BUF,TBL,53,73
808,TBL,CAR,11,CAR,TBL,12,23
809,TBL,CBJ,20,CBJ,TBL,12,32
810,TBL,CGY,10,CGY,TBL,10,20
811,TBL,CHI,59,CHI,TBL,74,133
812,TBL,COL,7,COL,TBL,4,11
813,TBL,DAL,3,DAL,TBL,1,4
814,TBL,DET,23,DET,TBL,23,46
815,TBL,EDM,6,EDM,TBL,12,18
816,TBL,LAK,8,LAK,TBL,1,9
817,TBL,MIN,16,MIN,TBL,5,21
818,TBL,MTL,12,MTL,TBL,47,59
819,TBL,NJD,25,NJD,TBL,87,112
820,TBL,NSH,15,NSH,TBL,5,20
821,TBL,NYI,5,NYI,TBL,3,8
822,TBL,NYR,12,NYR,TBL,14,26
823,TBL,OTT,20,OTT,TBL,46,66
824,TBL,PHI,38,PHI,TBL,39,77
825,TBL,PIT,11,PIT,TBL,56,67
826,TBL,SJS,29,SJS,TBL,11,40
827,TBL,STL,18,STL,TBL,17,35
828,TBL,TOR,6,TOR,TBL,33,39
829,TBL,VAN,16,VAN,TBL,68,84
830,TBL,VGK,3,VGK,TBL,1,4
831,TBL,WPG,31,WPG,TBL,29,60
832,TBL,WSH,8,WSH,TBL,4,12
833,TOR,ANA,491,ANA,TOR,38,529
834,TOR,ARI,919,ARI,TOR,51,970
835,TOR,BOS,66,BOS,TOR,14,80
836,TOR,BUF,235,BUF,TOR,49,284
837,TOR,CAR,345,CAR,TOR,110,455
838,TOR,CBJ,299,CBJ,TOR,57,356
839,TOR,CGY,695,CGY,TOR,183,878
840,TOR,CHI,692,CHI,TOR,197,889
841,TOR,COL,194,COL,TOR,42,236
842,TOR,DAL,154,DAL,TOR,19,173
843,TOR,DET,196,DET,TOR,111,307
844,TOR,EDM,176,EDM,TOR,42,218
845,TOR,FLA,50,FLA,TOR,12,62
846,TOR,LAK,401,LAK,TOR,40,441
847,TOR,MIN,182,MIN,TOR,23,205
848,TOR,MTL,120,MTL,TOR,74,194
849,TOR,NJD,135,NJD,TOR,71,206
850,TOR,NSH,229,NSH,TOR,32,261
851,TOR,NYI,155,NYI,TOR,44,199
852,TOR,NYR,200,NYR,TOR,74,274
853,TOR,OTT,121,OTT,TOR,42,163
854,TOR,PHI,694,PHI,TOR,158,852
855,TOR,PIT,392,PIT,TOR,183,575
856,TOR,SEA,219,SEA,TOR,15,234
857,TOR,SJS,466,SJS,TOR,86,552
858,TOR,STL,211,STL,TOR,34,245
859,TOR,TBL,33,TBL,TOR,6,39
860,TOR,VAN,365,VAN,TOR,104,469
861,TOR,VGK,91,VGK,TOR,10,101
862,TOR,WPG,512,WPG,TOR,99,611
863,TOR,WSH,319,WSH,TOR,70,389
864,VAN,ANA,309,ANA,VAN,47,356
865,VAN,ARI,235,ARI,VAN,50,285
866,VAN,BOS,92,BOS,VAN,44,136
867,VAN,BUF,74,BUF,VAN,83,157
868,VAN,CAR,108,CAR,VAN,43,151
869,VAN,CBJ,178,CBJ,VAN,65,243
870,VAN,CGY,59,CGY,VAN,27,86
871,VAN,CHI,256,CHI,VAN,231,487
872,VAN,COL,35,COL,VAN,26,61
873,VAN,DAL,68,DAL,VAN,11,79
874,VAN,DET,112,DET,VAN,99,211
875,VAN,EDM,22,EDM,VAN,48,70
876,VAN,FLA,88,FLA,VAN,12,100
877,VAN,LAK,47,LAK,VAN,6,53
878,VAN,MIN,45,MIN,VAN,20,65
879,VAN,MTL,96,MTL,VAN,103,199
880,VAN,NJD,73,NJD,VAN,58,131
881,VAN,NSH,166,NSH,VAN,39,205
882,VAN,NYI,49,NYI,VAN,32,81
883,VAN,NYR,78,NYR,VAN,49,127
884,VAN,OTT,94,OTT,VAN,45,139
885,VAN,PHI,78,PHI,VAN,66,144
886,VAN,PIT,216,PIT,VAN,278,494
887,VAN,SEA,37,SEA,VAN,8,45
888,VAN,SJS,43,SJS,VAN,24,67
889,VAN,STL,29,STL,VAN,12,41
890,VAN,TBL,68,TBL,VAN,16,84
891,VAN,TOR,104,TOR,VAN,365,469
892,VAN,VGK,25,VGK,VAN,7,32
893,VAN,WPG,105,WPG,VAN,66,171
894,VAN,WSH,113,WSH,VAN,44,157
895,VGK,ANA,9,ANA,VGK,15,24
896,VGK,ARI,13,ARI,VGK,13,26
897,VGK,BOS,6,BOS,VGK,21,27
898,VGK,BUF,8,BUF,VGK,61,69
899,VGK,CAR,7,CAR,VGK,13,20
900,VGK,CBJ,3,CBJ,VGK,20,23
901,VGK,CGY,4,CGY,VGK,10,14
902,VGK,CHI,16,CHI,VGK,24,40
903,VGK,COL,4,COL,VGK,10,14
904,VGK,DAL,2,DAL,VGK,2,4
905,VGK,DET,11,DET,VGK,20,31
906,VGK,EDM,3,EDM,VGK,9,12
907,VGK,FLA,4,FLA,VGK,9,13
908,VGK,LAK,5,LAK,VGK,2,7
909,VGK,MIN,5,MIN,VGK,3,8
910,VGK,MTL,4,MTL,VGK,38,42
911,VGK,NJD,3,NJD,VGK,23,26
912,VGK,NSH,2,NSH,VGK,5,7
913,VGK,NYI,4,NYI,VGK,6,10
914,VGK,NYR,2,NYR,VGK,24,26
915,VGK,OTT,19,OTT,VGK,41,60
916,VGK,PHI,8,PHI,VGK,27,35
917,VGK,PIT,14,PIT,VGK,53,67
918,VGK,SEA,6,SEA,VGK,6,12
919,VGK,SJS,7,SJS,VGK,6,13
920,VGK,STL,2,STL,VGK,9,11
921,VGK,TBL,1,TBL,VGK,3,4
922,VGK,TOR,10,TOR,VGK,91,101
923,VGK,VAN,7,VAN,VGK,25,32
924,VGK,WPG,6,WPG,VGK,22,28
925,VGK,WSH,4,WSH,VGK,8,12
926,WPG,ANA,66,ANA,WPG,10,76
927,WPG,ARI,111,ARI,WPG,18,129
928,WPG,BOS,75,BOS,WPG,63,138
929,WPG,BUF,194,BUF,WPG,304,498
930,WPG,CAR,177,CAR,WPG,147,324
931,WPG,CBJ,75,CBJ,WPG,52,127
932,WPG,CGY,63,CGY,WPG,43,106
933,WPG,CHI,68,CHI,WPG,32,100
934,WPG,COL,95,COL,WPG,89,184
935,WPG,DAL,26,DAL,WPG,8,34
936,WPG,DET,185,DET,WPG,128,313
937,WPG,EDM,66,EDM,WPG,127,193
938,WPG,FLA,73,FLA,WPG,12,85
939,WPG,LAK,183,LAK,WPG,83,266
940,WPG,MIN,60,MIN,WPG,22,82
941,WPG,MTL,326,MTL,WPG,618,944
942,WPG,NJD,111,NJD,WPG,104,215
943,WPG,NSH,28,NSH,WPG,20,48
944,WPG,NYI,40,NYI,WPG,43,83
945,WPG,NYR,76,NYR,WPG,44,120
946,WPG,OTT,81,OTT,WPG,76,157
947,WPG,PHI,65,PHI,WPG,42,107
948,WPG,PIT,86,PIT,WPG,237,323
949,WPG,SEA,67,SEA,WPG,19,86
950,WPG,SJS,18,SJS,WPG,15,33
951,WPG,STL,26,STL,WPG,13,39
952,WPG,TBL,29,TBL,WPG,31,60
953,WPG,TOR,99,TOR,WPG,512,611
954,WPG,VAN,66,VAN,WPG,105,171
955,WPG,VGK,22,VGK,WPG,6,28
956,WPG,WSH,111,WSH,WPG,75,186
957,WSH,ANA,35,ANA,WSH,14,49
958,WSH,ARI,133,ARI,WSH,27,160
959,WSH,BOS,32,BOS,WSH,61,93
960,WSH,BUF,17,BUF,WSH,62,79
961,WSH,CAR,30,CAR,WSH,20,50
962,WSH,CBJ,109,CBJ,WSH,29,138
963,WSH,CGY,42,CGY,WSH,34,76
964,WSH,CHI,70,CHI,WSH,98,168
965,WSH,COL,79,COL,WSH,74,153
966,WSH,DAL,10,DAL,WSH,4,14
967,WSH,DET,12,DET,WSH,31,43
968,WSH,EDM,18,EDM,WSH,79,97
969,WSH,FLA,11,FLA,WSH,8,19
970,WSH,LAK,24,LAK,WSH,13,37
971,WSH,MIN,26,MIN,WSH,21,47
972,WSH,MTL,74,MTL,WSH,186,260
973,WSH,NJD,28,NJD,WSH,46,74
974,WSH,NSH,14,NSH,WSH,11,25
975,WSH,NYI,6,NYI,WSH,2,8
976,WSH,NYR,14,NYR,WSH,31,45
977,WSH,OTT,67,OTT,WSH,67,134
978,WSH,PHI,38,PHI,WSH,33,71
979,WSH,PIT,7,PIT,WSH,39,46
980,WSH,SEA,38,SEA,WSH,4,42
981,WSH,SJS,42,SJS,WSH,33,75
982,WSH,STL,19,STL,WSH,14,33
983,WSH,TBL,4,TBL,WSH,8,12
984,WSH,TOR,70,TOR,WSH,319,389
985,WSH,VAN,44,VAN,WSH,113,157
986,WSH,VGK,8,VGK,WSH,4,12
987,WSH,WPG,75,WPG,WSH,111,186
